{
    "slug": "hurry",
    "name": "We're in a hurry!",
    "size": {"r": 15, "c": 10},
    "path": [
        {"r": -1, "c": 4},
        {"r": 0, "c": 4},
        {"r": 1, "c": 4},
        {"r": 2, "c": 4},
        {"r": 3, "c": 4},
        {"r": 4, "c": 4},
        {"r": 5, "c": 4},
        {"r": 6, "c": 4},
        {"r": 7, "c": 4},
        {"r": 8, "c": 4},
        {"r": 9, "c": 4},
        {"r": 10, "c": 4},
        {"r": 11, "c": 4},
        {"r": 11, "c": 5},
        {"r": 11, "c": 6},
        {"r": 12, "c": 6},
        {"r": 13, "c": 6},
        {"r": 14, "c": 6},
        {"r": 15, "c": 6}
    ],
    "plateaus": [
        {"r": 0, "c": 4},
        {"r": 1, "c": 2},
        {"r": 1, "c": 4},
        {"r": 2, "c": 8},
        {"r": 3, "c": 1},
        {"r": 3, "c": 6},
        {"r": 5, "c": 4},
        {"r": 5, "c": 5},
        {"r": 6, "c": 7},
        {"r": 7, "c": 2},
        {"r": 7, "c": 5},
        {"r": 9, "c": 0},
        {"r": 9, "c": 1},
        {"r": 9, "c": 2},
        {"r": 9, "c": 6},
        {"r": 9, "c": 7},
        {"r": 9, "c": 8},
        {"r": 9, "c": 9},
        {"r": 10, "c": 4},
        {"r": 12, "c": 3},
        {"r": 12, "c": 4},
        {"r": 12, "c": 6},
        {"r": 14, "c": 7}
    ]
}