{
    "slug": "waiting_line",
    "name": "I hate waiting lines",
    "size": {"r": 15, "c": 10},
    "path": [
        {"r": 1, "c": -1},
        {"r": 1, "c": 0},
        {"r": 1, "c": 1},
        {"r": 1, "c": 2},
        {"r": 1, "c": 3},
        {"r": 1, "c": 4},
        {"r": 2, "c": 4},
        {"r": 3, "c": 4},
        {"r": 3, "c": 3},
        {"r": 3, "c": 2},
        {"r": 3, "c": 1},
        {"r": 4, "c": 1},
        {"r": 5, "c": 1},
        {"r": 5, "c": 2},
        {"r": 5, "c": 3},
        {"r": 5, "c": 4},
        {"r": 5, "c": 5},
        {"r": 5, "c": 6},
        {"r": 5, "c": 7},
        {"r": 6, "c": 7},
        {"r": 7, "c": 7},
        {"r": 7, "c": 6},
        {"r": 7, "c": 5},
        {"r": 7, "c": 4},
        {"r": 7, "c": 3},
        {"r": 7, "c": 2},
        {"r": 8, "c": 2},
        {"r": 9, "c": 2},
        {"r": 9, "c": 3},
        {"r": 9, "c": 4},
        {"r": 9, "c": 5},
        {"r": 9, "c": 6},
        {"r": 9, "c": 7},
        {"r": 9, "c": 8},
        {"r": 10, "c": 8},
        {"r": 11, "c": 8},
        {"r": 11, "c": 7},
        {"r": 11, "c": 6},
        {"r": 11, "c": 5},
        {"r": 12, "c": 5},
        {"r": 13, "c": 5},
        {"r": 13, "c": 6},
        {"r": 13, "c": 7},
        {"r": 13, "c": 8},
        {"r": 13, "c": 9},
        {"r": 13, "c": 10}
    ],
    "plateaus": []
}